17 13
14 14 14 1 5 5 1 3 14 1 9 9 9 9 3 23 1
14 1 9 9 3 21 2 4 1 9 3 1 3 22 6 1 4
7 4 18 14 10 23 21 14 14 22 2 10 2 9 9 5 14
14 14 23 13 2 5 3 14 1 9 9 4 23 14 14 2 5
9 9 3 19 1 5 4 23 2 3 22 14 14 1 4 1 5
14 22 9 9 5 5 9 3 14 10 14 20 14 10 17 10 14
13 5 9 9 3 21 22 6 1 9 9 3 1 9 9 4 8
13 6 14 23 6 5 5 2 4 20 14 2 4 19 1 9 4
5 6 23 14 1 3 21 14 14 1 9 3 21 13 10 23 14
7 9 9 9 4 2 5 3 14 13 21 10 21 13 10 1 9
14 14 10 22 14 17 6 2 3 13 1 9 3 21 2 10 14
5 5 5 5 3 17 6 23 10 22 6 14 2 3 23 10 14
21 2 5 5 4 14 21 14 2 5 4 22 14 2 9 4 21
